###############################
#      # #                #  .#
#      #     #      #  #  #  ##
# $g#     #      #   g    ## ##
#      #   # ### #    #    #  #
#   ###### #     # #          #
#####    # #       # # #  ## ##
#      # # #### # #  # #   #  #
#   #  # #      #   #  # # ## #
##$##       #       #  # # #  #
#   #  # #      #   #  # # # ##
### #  # # ###g # # #  # #   ##
#@  #    #      #   #        .#
###############################
