#################
#################
####         ####
#### @    $  ####
####         ####
#########    ####
#### .       ####
####         ####
#################
#################
