#################
#################
####         ####
#### $  @  $ ####
####  $   $  ####
####   $ $   ####
####    $  z ####
####         ####
#################
#################
