###############
###############
####       ####
#### @ . $ ####
####       ####
###############
###############
