###################
####           ####
####     z     ####
#####$ $ $ $ $#####
####           ####
####  $ $ $ $  ####
####           ####
####     @     ####
####g         g####
###################
