###############
###############
####       ####
#### @ $ . ####
####       ####
###############
###############
