#############################
#####   $           $   #####
#####    $    $    $    #####
##### $   $       $   $ #####
#####   $  $     $  $   #####
#####  $z    $$$    z$  #####
#####       $   $       #####
##### $ $ $ $ @ $ $ $ $ #####
#####       $   $       #####
#####  $z    $$$    z$  #####
#####   $  $     $  $   #####
##### $   $       $   $ #####
#####    $    $    $    #####
#####   $           $   #####
#############################
