###############################
#@       #    ###    #        #
#   ###  $           $        #
######## ##   #$#   ###       #
#        ##   # #   ###  g    #
#  ## ######       ####       #
# $           ###        # ## #
###   #  #     #     #   #  $ #
#     #  # ##     ## #   # ####
#        #     g  #      #    #
#  # ### #   ######  #  g     #
#  #  g     #  #  #       ##  #
#  #  #  #  #  #  #  #  #  #  #
#  .     .     .     .     .  #
###############################

