#################
##       #     ##
##   z  $ $    ##
#   #  #   $   ##
#   .#$     @  ##
#   #  #   $   ##
##   z  $ $    ##
##       #     ##
#################
