###################
###    #    $   ###
###   $$     #  ###
###  $  $  g  $ ###
### $    $     $###
####  z   $    ####
### $#$    #   $###
### @  $    $ $ ###
###     $    $  ###
###################
