#################
#################
####         ####
#### @    $$ ####
####         ####
#########    ####
#### .       ####
#### .       ####
#################
#################
