#############################
######                 ######
######        i        ######
######                 ######
######                 ######
######    r   @   S    ######
######                 ######
######                 ######
######        c        ######
######                 ######
#############################
