#############################
######                 ######
######        i        ######
######                 ######
######                 ######
######    r   @   M    ######
######                 ######
######                 ######
######        C        ######
######                 ######
#############################
