#############################
#######                 #####
#######      i   R      #####
#######                 #####
#######                 #####
#######    e   @   s    #####
#######                 #####
#######                 #####
#     #        m        #####
#     #                 #####
#############################
