#############################################
#############################################
###    $ $$$              $        $$$   z ##
##  z$  $   #   $    $$$$$    $$   $       ##
##        $                    $           ##
##     $$$$$ $    $$$$$      $       $$$$$$##
##     $$$$     $        $     $ $         ##
##   $$   $                     $$$$       ##
##$$           $$  $  @+       $      $    ##
##    $              $$$$$$    $           ##
##            $        $$$      $$$   $$$$$##
##   $$$     $    $     $$   #     $$$$$   ##
##          $$$                    $$$     ##
##          $    # $$   $     $         #  ##
## z     $   $              $$$$   $$$     ##
#### $$$$$ $$$                           z ##
#############################################
#############################################
