#####################################
######       #                 ######
######       #                 ######
######       #                 ######
######       #                 ######
######  n    #                 ######
######       #                 ######
######  @    #                 ######
######       #                 ######
######  r    #                 ######
######       #                 ######
######       #                 ######
######       #                 ######
######       #                 ######
#####################################
