#############################
######    |||||||||||||######
######  n |...%...||  |######
######    |||||||||||||######
######       ||||      ######
######  @    |.%|      ######
######       ||||      ######
######    |||||||||    ######
######  r |...%...|    ######
######    |||||||||    ######
#############################
